#######################################
# Datatypes (KEYWORD1)
#######################################

devduino	KEYWORD1
Bcd	KEYWORD1
Board	KEYWORD1
Console	KEYWORD1
DateTime	KEYWORD1
Font	KEYWORD1
DevduinoFont	KEYWORD1
Display	KEYWORD1
Rtc	KEYWORD1
Spreadsheet	KEYWORD1
Sprite	KEYWORD1
Temperature	KEYWORD1

#######################################
# Methods and Functions (KEYWORD2)
#######################################

toBinary	KEYWORD2
fromBinary	KEYWORD2
begin	KEYWORD2
attachToIntButton	KEYWORD2
getDisplay	KEYWORD2
setTextPosition	KEYWORD2
setFont	KEYWORD2
getFont	KEYWORD2
setFontSize	KEYWORD2
getFontSize	KEYWORD2
newLine	KEYWORD2
print	KEYWORD2
println	KEYWORD2
flush	KEYWORD2
enableAutoFlush	KEYWORD2
getYear	KEYWORD2
getMonth	KEYWORD2
getDay	KEYWORD2
getHour	KEYWORD2
getMinute	KEYWORD2
getSecond	KEYWORD2
toDayEpoch	KEYWORD2
toDay	KEYWORD2
toDayOfWeek	KEYWORD2
getSize	KEYWORD2
getGlyphWidth	KEYWORD2
getGlyphHeight	KEYWORD2
getGlyphPixels	KEYWORD2
getGlyphKerning	KEYWORD2
getWidth	KEYWORD2
getHeight	KEYWORD2
drawLine	KEYWORD2
drawHorizontalLine	KEYWORD2
drawVerticalLine	KEYWORD2
drawRectangle	KEYWORD2
fillRectangle	KEYWORD2
drawCircle	KEYWORD2
fillCircle	KEYWORD2
verticalScroll	KEYWORD2
resetVerticalScroll	KEYWORD2
getVerticalScroll	KEYWORD2
continuousVerticalScroll	KEYWORD2
stopContinuousVerticalScroll	KEYWORD2
drawBuffer	KEYWORD2
drawSprite	KEYWORD2
drawPixel	KEYWORD2
clear	KEYWORD2
clearArea	KEYWORD2
clearPixel	KEYWORD2
setScale	KEYWORD2
getScale	KEYWORD2
setDateTime	KEYWORD2
now	KEYWORD2
setGrid	KEYWORD2
enableDrawBorders	KEYWORD2
getBuffer	KEYWORD2
read	KEYWORD2
shutdown	KEYWORD2
wakeup	KEYWORD2

#######################################
# Instances (KEYWORD2)
#######################################

#######################################
# Constants (LITERAL1)
#######################################